NO ./textures/purplestone.xpm       F    255,128,111




SO ./textures/mossy.xpm        WE               ./textures/redbrick.xpm 



         EA    ./textures/wood.xpm              C 42,82,190         




1111
1001
1111
     11111111111
1111100100000001
1000001 1S001111
10000011 11001
1000000010011
111110000000011111
    100000000001
    100000000111
 11111111111111
